    01 01 05 01 05 01 01 01 01 01 01 01 01 01 01 01 01 04 04 01 
    00 00 00 00 00 00 00 00 01 05 01 04 01 01 01 04 01 04 01 01 
    00 00 00 00 00 00 00 00 00 01 01 01 01 04 04 01 04 04 03 01 
    00 00 00 00 00 00 00 00 00 01 01 01 01 01 01 02 02 02 02 01 
    05 01 01 00 00 00 00 00 00 00 00 01 01 01 01 04 01 04 03 05 
    01 01 04 04 01 00 00 00 00 00 00 00 00 00 01 01 01 01 01 01 
    01 04 01 04 01 00 0A 0B 00 00 00 00 00 00 00 00 00 00 00 00 
    05 01 01 01 01 01 04 01 01 01 05 01 05 00 00 00 00 00 00 00 
    01 01 01 04 01 01 01 04 01 04 01 01 01 04 01 01 01 01 01 01 
    01 04 01 01 01 01 01 01 01 01 01 04 01 01 01 01 04 01 01 05 

	
	01 01 05 01 05 FF 01 0C 04 04 01								11
	FF 00 08 01 05 01 04 01 01 01 04 01 04 01 01					15
	FF 00 09 FF 01 04 04 04 01 04 04 03 01							13
	FF 00 09 FF 01 06 FF 02 04 01									10
	05 01 01 FF 00 08 FF 01 04 04 01 04 03 05						14
	01 01 04 04 01 FF 00 09 FF 01 06								11
	01 04 01 04 01 00 0A 0B FF 00 0C								11
	05 FF 01 05 04 01 01 01 05 01 05 FF 00 07						14
	01 01 01 04 01 01 01 04 01 04 01 01 01 04 FF 01 06				17
	01 04 FF 01 09 04 FF 01 04 04 01 01 05							13
	
	
	
	